map_info {
  name: "sensor map"
  x_min_y_max_cell: {
    x: -100
    y: 100
  }
  resolution: 0.065
  x_range: 151
  y_range: 153
}
data: 
      "..WWWWWWWWWWWWWWWWWWWWWWWWWWWWWWWWWWWWWWWWWWWWWWWWWWWWWWWWWWWWWWWWWWWWWWWWWWWWWWWWWWWWWWWWWWWWWWWWWWWWWWWWWWWWWWWWWWWWWWWWWWWWWWWWWWWWWWWWWWWWWWWWWWW.."
      "..W................................................W..................................W.............................................................W.."
      "..W................................................W..................................W.............................................................W.."
      "..W................................................W..................................W.............................................................W.."
      "..W................................................W..................................W.............................................................W.."
      "..W................................................W..................................W.............................................................W.."
      "..W................................................W..................................W.............................................................W.."
      "..W................................................W..................................W.............................................................W.."
      "..W................................................W..................................W.............................................................W.."
      "..W................................................W..................................W.............................................................W.."
      "..W................................................W..................................W.............................................................W.."
      "..W................................................W..................................W.............................................................W.."
      "..W................................................W..................................W.............................................................W.."
      "..W................................................W..................................W.............................................................W.."
      "..W................................................W..................................W.............................................................W.."
      "..W................................................W..................................W.............................................................W.."
      "..W................................................W..................................W.............................................................W.."
      "..W................................................WWWWWWWW....................WWWWWWWW.............................................................W.."
      "..W................................................W..................................W.............................................................W.."
      "..W................................................W..................................W.............................................................W.."
      "..W.............................................WWWW..................................W.............................................................W.."
      "..W...................................................................................W.............................................................W.."
      "..W...................................................................................W.............................................................W.."
      "..W...................................................................................W.............................................................W.."
      "..W...................................................................................W.............................................................W.."
      "..W...................................................................................W.............................................................W.."
      "..W...................................................................................W.............................................................W.."
      "..W...................................................................................W.............................................................W.."
      "..W...................................................................................W.............................................................W.."
      "..W...................................................................................W.............................................................W.."
      "..WWWWWWWWWWWWWWWWWWWWWWWWWWWWWWWWWWWWWWWWWWWWWWWWWW..................................W....................WWWWWWWWWWWWWWWWWWWWWWWWWWWWWWWWWWWWWWWWWW.."
      "..W.................................................................................................................................................W.."
      "..W.................................................................................................................................................W.."
      "..W.................................................................................................................................................W.."
      "..W................................................................................................................W........W.......................W.."
      "..W.................................................................................................................................................W.."
      "..W.................................................................................................................................................W.."
      "..W.................................................................................................................................................W.."
      "..W.................................................................................................................................................W.."
      "..W.................................................................................................................................................W.."
      "..W.................................................................................................................................................W.."
      "..W................................................................................................................W........W.......................W.."
      "..W.....................................................................................................W...........................W...............W.."
      "..W................................................W................................................................................................W.."
      "..W................................................W.......................................W.........W................................W.........W...W.."
      "..W................................................W................................................................................................W.."
      "..W................................................W................................................................................................W.."
      "..W................................................W................................................................................................W.."
      "..W................................W...............W................................................................................................W.."
      "..W................................W...............W................................................................................................W.."
      "..W................................W...............W................................................................................................W.."
      "..W................................W...............W.......................................W.........W................................W.........W...W.."
      "..W................................W...............W................................................................................................W.."
      "..W................................W...............W....................................................W...........................W...............W.."
      "..W................................W...............W................................................................................................W.."
      "..W................................W...............W...............................................................W.........W......................W.."
      "..W................................W...............W................................................................................................W.."
      "..W................................W...............W................................................................................................W.."
      "..W................................W...............W................................................................................................W.."
      "..W................................W...............W................................................................................................W.."
      "..W................................W...............W................................................................................................W.."
      "..W................................W...............W................................................................................................W.."
      "..W................................W...............W...............................................................W.........W......................W.."
      "..W................................W...............W................................................................................................W.."
      "..W................................W...............W................................................................................................W.."
      "..W................................W...............W................................................................................................W.."
      "..W................................W...............W................................................................................................W.."
      "..WWWWWWWWWWWWWWWWWWWWWWWWWWWWWWWWWWWWWWWWWWWWWWWWWW................................................................................................W.."
      "..W.................................................................................................................................................W.."
      "..W.................................................................................................................................................W.."
      "..W.................................................................................................................................................W.."
      "..W.................................................................................................................................................W.."
      "..W.................................................................................................................................................W.."
      "..W.................................................................................................................................................W.."
      "..W.........................................................................................................................WWWWWWWWWWWWWWWWWWWWWWWWW.."
      "..W.........................................................................................................................W.......................W.."
      "..W.........................................................................................................................W.......................W.."
      "..W.........................................................................................................................W.......................W.."
      "..W.........................................................................................................................W.......................W.."
      "..WWWWWWWWWWWWW.............................................................................................................W.......................W.."
      "..W...........W.............................................................................................................W.......................W.."
      "..W...........W.....................................................................................................................................W.."
      "..W...........W........................................................W....................W.......................................................W.."
      "..W...........W.....................................................................................................................................W.."
      "..W...........W.....................................................................................................................................W.."
      "..W...........W.....................................................................................................................................W.."
      "..W...........W.....................................................................................................................................W.."
      "..W...........W.....................................................................................................................................W.."
      "..W...........W.....................................................................................................................................W.."
      "..W...........W.....................................................................................................................................W.."
      "..W...........W.....................................................................................................................................W.."
      "..W...........W.....................................................................................................................................W.."
      "..W...........W.....................................................................................................................................W.."
      "..W...........W.....................................................................................................................................W.."
      "..W...........W.....................................................................................................................................W.."
      "..W...........W.....................................................................................................................................W.."
      "..W...........W.....................................................................................................................................W.."
      "..W...........W.....................................................................................................................................W.."
      "..W...........W.....................................................................................................................................W.."
      "..W...........W.....................................................................................................................................W.."
      "..W...........W.............................................................................................................W.......................W.."
      "..W...........W.............................................................................................................W.......................W.."
      "..W...........W.............................................................................................................W.......................W.."
      "..W...........W.............................................................................................................W.......................W.."
      "..W...........W.......................................................W.....................W...............................W.......................W.."
      "..W...........W.............................................................................................................W.......................W.."
      "..W...........W.............................................................................................................W.......................W.."
      "..WWWWWWWWWWWWW.............................................................................................................W.......................W.."
      "..W.........................................................................................................................W.......................W.."
      "..W.........................................................................................................................W.......................W.."
      "..W.........................................................................................................................W.......................W.."
      "..W.........................................................................................................................W.......................W.."
      "..W...........................................................wWWWWWWWWWWWWWW...................................WWWWWWWWWWWWW.......................W.."
      "..W...........................................................w.....................................................................................W.."
      "..W...........................................................w.....................................................................................W.."
      "..W....WWWW...................................................w.....................................................................................W.."
      "..W..WW....WW.......................................................................................................................................W.."
      "..W.W........W......................................................................................................................................W.."
      "..WW..........W.....................................................................................................................................W.."
      "..WW..........W.....................................................................................................................................W.."
      "..W.W........W......................................................................................................................................W.."
      "..W..WW....WW.................................................W.....................................................................................W.."
      "..W....WWWW...................................................W.....................................................................................W.."
      "..W...........................................................W.....................................................................................W.."
      "..W...........................................................WWWWWWWWWWWWWWW...................................WWWWWWWWWWWWWWWWWWWWWWWWWWWWWWWWWWWWW.."
      "..W.................................................................................................................................................W.."
      "..W.................................................................................................................................................W.."
      "..W.................................................................................................................................................W.."
      "..W.................................................................................................................................................W.."
      "..W.......................W.........................................................................................................................W.."
      "..W..................W....W....W....................................................................................................................W.."
      "..W...................WW..W..WW.....................................................................................................WWWWWWWWWWWWWWWWW.."
      "..W.....................WWWWW.......................................................................................................................W.."
      "..W......................W.W........................................................................................................................W.."
      "..W.....................W...W.......................................................................................................................W.."
      "..W....................W.....W......................................................................................................................W.."
      "..W.................................................................................................................................................W.."
      "..W.................................................................................................................................................W.."
      "..W.................................................................................................................................................W.."
      "..W.................................................................................................................................W...............W.."
      "..W..W...............................................W..............................................................................W...............W.."
      "..W.................................................................................................................................W...............W.."
      "..W.................................................................................................................................W...............W.."
      "..W.................................................................................................................................W...............W.."
      "..W.................................................................................................................................W...............W.."
      "..W.................................................................................................................................W...............W.."
      "..W.................................................................................................................................W...............W.."
      "..W.................................................................................................................................W...............W.."
      "..W..W...............................................W..............................................................................W...............W.."
      "..W.................................................................................................................................WWWWWWWWWWWWWWWWW.."
      "..W.................................................................................................................................................W.."
      "..WWWWWWWWWWWWWWWWWWWWWWWWWWWWWWWWWWWWWWWWWWWWWWWWWWWWWWWWWWWWWWWWWWWWWWWWWWWWWWWWWWWWWWWWWWWWWWWWWWWWWWWWWWWWWWWWWWWWWWWWWWWWWWWWWWWWWWWWWWWWWWWWWWW.."
      "......................................................................................................................................................."